1. Abandon - tərk etmək
2. Abandoned - tərk edilmiş
3. Ability - imkan, qabiliyyət
4. Able - mümkün
5. Unable - qeyri mümkün
6. About - haqqında
7. Above - üzərində
8. Abroad - xaricdə
9. Absence - yoxluq
10. Absent - olmayan, tapılmayan
11. Absolute - tamamilə
12. Absolutely - tamamilə
13. Absorb - canına çəkmək
14. Abuse - pis istifadə etmək
15. Academic - akademik
16. Accent - ləhçə
17. Accept - qəbul etmək
18. Acceptable - qəbul ediləbilir
19. Unacceptable - qəbul ediləbilməz
20. Acces - giriş
21. Accident - qəza
22. by accident - təsadüfən
23. Accidental - təsadüfi
24. Accidentally - təsadüfi olaraq
25. Accomodation - qalma yeri, anlaşılmazlıq
26. Accompany - yoldaşlıq etmək (yolda)
27. According to  prep. - ...a, ...ə görə
28. Account - hesab, zənn etmək
29. Accurate. - dəqiq
30. Accurately - dəqiq olaraq
31. Accuse - günahlandırmaq
32. Achieve - nail olmaq
33. Achievement - nailiyyət
34. Acid - kimyəvi turşu
35. Acknowledge - qəbul etmək
36. Acquire - əldə etmək
37. Across - qarşı tərəfə
38. Act - hərəkətə keçmək
39. Action - hərəkət, action movie
40. Take action - hərəkətə keçmək
41. Active - fəal
42. Actively -fəal olaraq
43. Activity - fəaliyyət
44. Actor, actress - aktyor, aktrisa
45. Actual - əsl, həqiqi
46. Actually - əslində
47. Advertisement - reklam
48. Adapt - uyğunlaşdırmaq
49. Add - əlavə etmək
50. Addition - əlavə
1. Voyage - səfər, səyahət
2. Nearly - az qalsın
3. Cost - maliyyə
4. Sail - yelkən
5. Pirates - dəniz quldurları
6. Shore - sahil
7. Settle - yerləşmək
8. Shortcut - qısa yol, kəsdirmə
9. Sailor - dənizçi
10. Reality - gerçəklik, gerçək
11. Agree - qəbul etmək, anlaşmaq
12. Unfortunately - təəssüf ki
13. Refuse - zibil, qəbul etməmək,
14. Such - bu cür
15. Forced - məcburi
Seat - oturacaq
Useless - faydasız
Blame - günahlandırmaq
Research - tədqiqat
Suppose - güman etmək, tutaq ki, tutalım ki
Consider - düşünmək, nəzərə almaq
Approach - yanaşma, yanaşmaq
Hostage - əsir
Embrace - qucaqlamaq
embarrassing - utanc verici
Recognize - tanımaq
Finally - nəhayət
Reach - çatmaq, gəlib çatmaq
Thinker - mütəfəkkir
Judge - hakim
Switch - keçid, dəyişmək
Purse - pul kisəsi
Well-known - tanınmış
Fictional - uydurma
Minister - nazir
Prime minister - baş nazir
Stagnant - durğun
Elected - seçilmiş
Disenchantment - inciklik
Millennial - minillik
Staff - heyət
Rough - kobud
Uppermost - ən üst
Surface - səthi, yerüstü
Occurs - meydana gəlmək, baş vermək
Loud - ucadan
Noise - səs küy
Hired - muzdlu, kirəli
Fence - hasar, çəpər
Mosquito - ağcaqanad
Casino - qumarxana
Immediately - dərhal
Busy - hərəkətli, məşğul
Near - yaxın
Quiet - sakin
Waiter - ofisiant
Unemployed - işsiz
Order - sifariş
Bill - hesab, şot
Wine - şərab
a jug of ... (water) - bir banka ... (su)
Closure - qapanma
Might - qüdrət,güc .  ola bilər
Drastic - şiddətli
Ahead - qabaqda
Straight - düz
Pharmacy - aptek
Sequence - ardıcıllıq
Perspective - perspektiv, baxış açısı
Close up - bağlamaq
Isolation - təcrid, təcrid etmə
Tension - gərginlik
Deaf - kar
The envelope - zərf
Hearing aid - eşitmə cihazı
Consequence - nəticə
Leave - yarpaq
employee - çalışan, işçi
Staff - heyət
A boss - rəis, müdür
Sales - satış
IT - Information Technology
HR - Human Resources
Retail - pərakəndə
Healthcare - səhiyyə
Wallet - cüzdan
Loan - kredit
Mortgage - ipoteka
Debt, lent - borc
Make redundant - işdən çıxarmaq
Safe - təhlükəsiz
Advisable - məsləhətli
internal - daxili
Foreign - xarici
Main - əsas
Amusing - əyləncəli
Suitable - uyğun
Muddy - palçıqlı
Narrow - dar
Dead - ölü
Asleep - yuxulu
Awake - oyaq
Wounded - yaralı
injured - yaralı
Shallow - dayaz
Tiny, small - xırda
Giant, enermous - nəhəng
Huge - iri
Ashamed - utanmış
Frightened - qorxudulmuş
Displeased - narazı
Penniless - qəpiksiz
Jobless - işsiz
Moneyless - pulsuz
Separately - ayrı
Tight - sıx
Doubtful - şübhəli
Saint, sacret, holy  - müqəddəs
Scared - qorxmuş
Industrious - bacarıqlı
Agricultural - kənd təsərrüfatına aid olan
Cultural - mədəni
Economic - iqtisadi
Political - siyasi
Progressive - davamedici
Daily - gündəlik
Blond - sarışın
Faithful, devoted - sadiq
Historic - tarixi
Splendid - möhtəşəm, mükəmməl
Able - bacarıqlı
Urgent - təcili
Ordinary - adi
Genius - dahi
Pure - saf
Boiled - qaynadılmış
Rapid - cəld
Enjoyable - zövqlü
Chilled - sakit, dondurulmuş
Broaden, widen, expand, enlarge - genişləndirmək
Entertain, amuse - əyləndirmək
Escape - xilas olmaq
Foe - düşmən
Prohibit, forbid - qadağa etmək
Relieve - rahatlatmaq
Substance - maddə
Apart - başqa
Cub - bala
Stripe - zolaq
Gossip - qeybət
Favor - yaxşılıq
Eventually - nəhayət
Fuse - sığorta
Tiring - yorucu
Productive - məhsuldar, səmərəli
lawyer - vəkil
advocate - vəkil, müdafiə etmək
laundry, launderette - çamaşırxana
perhaps, maybe  - bəlkə
peacock - tovuzquşu
essential, important, necessary - təməl, vacib
scuba dive - tüplü dalış
attention - diqqət
soft - yumşaq, xəfif
guard - qoruma, növbətçi qorumaq
image - görüntü
immediate(ly) - tez, dərhal
response, answer, reply  - qarşılıq, cavab
thought - düşüncə
primary - ilk, birinci, başlıca
to remain - qalmaq
sette, couch, loung (living room) - divan
site, place - yer
certain, sure - əmin
rear, back - arxa
goddess - tanrıça
intermittent - aralıqlı, kəsik-kəsik
decision - qərar
compete - rəqabət
introduce - tanıtmaq, tanışdırmaq 
drug - narkotik, dərman
nostril - burun deşiyi
sign - iz
hostile - ədavətli
hunger - aclıw
react - qarşılamaq
outer - çöldəki, xarici
room - yer (uncountable)
purpose - niyyət
plate - təbəqə
crust - qabıq
hemisphere - yarımkürə
memorize - əzbərdən
respond - cavablandırmaq, cavab vermək
sight - görmə qabiliyyəti
amount - miqdar
broom - süpürgə
extinction - tükənmə
renewable - tükənməz
roof - dam
entire - bütün, tam
determined - yaratmaq
fold up - qatlamaq
carry - daşımaq
royalty - krallara məxsus
afford - üstünlük vermək
against - qarşı
ordinary - object
fertilizer - süni gübrə
primarily - əsasən
cultivate - əkmək, yetişdirmək
roast(ed)  - qızartmaq, (qızardılmış)
shiny - parıltılı
without hesitation - tərəddüd etmədən
curious - maraqlı, qəribə
vary - fərqlənmək
overtime - artıq iş vaxtı, mesai
duty - vəzifə
appearance - görünüş
deserted, desolate - ıssız, kimsəsi, (yer)
outline - sujet xətti
description - açıqlama
sheet - kağız lövhə
to wonder - maraqlanmaq, merak etmek
grocery - baqqal
excite - həyəcanlanmaq
anxious - narahat
eager - istəkli
pace - sürət, addım
intent - niyyət, məqsəd
spill - tökmək
seek - axtarmaq
possess - sahib olmaq
lung - ağciyər
load - yükləmək
hint, clue - ipucu
appreciate - dəyər vermək, anlamaq, başa düşmək
available - müsait, hazır
beat - keçmək (yarışda)
determine - müəyyənləşdirmək
flow - axmaq, tökülmək
hill - təpə
puddle - su yığıntısı
whether - ya , əgər
crawling - iməkləmək
reasonable - məntiqə uyğun, ağla yatan
division - bölünmə, bölmə
volunteer - könüllü
approval - təsdiq
seal - möhür
avalanche - uçqun
on purpose - qəsdən
church - kilsə
worship - itaət etmək
breed - tərbiyə etmək
to insist - dirəşmək ısrar etmək
divorce - boşanmaq
adolescence - yetkinlik
go out with (smb) - görüşə çıxmaq
punctual - dəqiqliklə
impression - təəssürat
ambitious - iddialı
split up - ayrılıq (ending of relationship)
consider - düşünmək
considere - nəzərə almaq
crude - xam, çiy
enzyme - ferment
coagulating, clot  - laxtalanma
citrate - sitrat
excessive - həddindən artıq
occurred - meydana gəldi
transfusing - qan köçürmə
clump - yığmaq
recipient - alıcı
crucial - həll edici
outlawed - qanundan xaric etmək
vital - həyati
disrupt - pozmaq
latch out - çıxartmaq
embedded - əlaqədar
intruder - içəri girən
distinguish - fərqləndirmək
withdrew - geri çəkildi
insert - daxil etmək
hemorrhage - qanaxma
regard - münasibət
reflect - əks etdirmək
represent - təqdim etmək
involve - əhatə etmək
injustice - ədalətsizlik
conclusion - nəticə
bother - narahat olmaq
bliss - zövq, xoşbəxtlik
lure - cəzb etmək
depict - təsvir etmək
boundary - sərhəd
summary - xülasə
fit - uyğun
supervisor, warden - nəzarətçi, keşikçi
unabashedly - səbirsiz
go over, revise - yenidən baxmaq
enthusiastic - həvəsli
jurist - hüquqşünas
inimical - xas olmayan
effort - səy, cəhd
rattled - xırıltılı
rat - siçovul
resemble - bənzəmək, oxşar olmaq
rodent - gəmirici
pole - dirək
match - uyğunluq
advance - irəliləyiş
regret - təəssüf
instance - misal
associate - əlaqələndirmək, partner
unite - birləşmək
task - tapşırıq
strike - vurmaq
cheer - şadlanmaq
pressure - təzyiq
convince, persuade - inandırmaq
pouch - çanta
digest - həzm etmək
chuckle - boğmaq
ambassador - səfir
dormitory - yataqxana
fizzy - qazlı içki, qızdırıcı
assume, suppose  - fərz etmək, güman
gross - kobud
remedy - çarə
alter - dəyişdirmək
teardrop - gözyaşı
grief - qəm
wail - fəryad
to weep - ağlamaq
consciousness - şürluluq
reassemble - yenidən yığmaq/yığılmaq
disgust - iyrənmək
whir - çırpınmaq
delectable - ləzzətli
exquisite - nəfis
appetizing - iştahaçan
dare - cəsarət etmək
heifer - düyə
fraudulent - saxtakarlıq
imposter - təhrikçi
accoutrement - uyğunlaşma
accordion - qarmon
volatile - uçucu
ramification - qol - budaq atmaq
screw - bolt, şurup
deride - lağ etmək
pliable - üzüyumuşaq, yolayaxın
covert - gizli
startling - təəccüblü
emit - yaymaq, saçmaq
unperturbed - narahat olmayan
rebuff -  dözmək
aware - farkında olmak
therefore - buna görə, bunun üçün
contagion - yoluxma, salgın
outbreak - partlayış, çıxmaq
counsel - nəsihət, tövsiyə
ensure - təmin etmək
remote - uzaq, ucqar
statue - heykəl
misty - dumanlı
suburb - şəhər kənarı
cope with - öhdəsindən gəlmək
commuter - səyyar işçi
commit - törətmək işləmək
manslaughter - adam öldürmək
bureaucracy - bürokratiya
cunningly - hiyləgərcəsinə,
friar - keşiş
cloak - pelerin
Triumphantly - zəfərlə
gleeful - şad
humble - təvazökar
suspicious - şübhəli
sake - xatir
union - birlik
thus - beləliklə
convey - çatdırmaq, daşımaq
adore - pərəstiş etmək, dəlicəsinə sevmək
devoure - yeyib qutarmaq, (acgözlüklə)
persist - davam etmək
indigestion - həzmsizlik
inhale - nəfəs almaq, hava almaq
spur - təkan, tələsdirmək
a sum of - cəmi
remittance - pul köçürmə, barat
scrap - qırıq, kəsik
do away with, abolish - ortadan qaldırmaq, yox etmək
unmanned - insansız
feline - pişik
revulsion - üsyan, nifrət hissi
unrelated - əlaqəsiz
hasten - tələsdirmək, sürətləndirmək
regardless - nə olursa olsun
thoroughly - yaxşıca, hərtərəfli
sedative - sakitləşdirici
priority - öncəlik
proceed - davam etmək
angle - bucaq
aqueous - sulu
reputable - nüfuzlu, möhtərəm
candidate - namizəd
bargain - sövdələşmə
pedestrian - piyada
principal - başlıca, əsas
boldly - cəsarətlə
bumpy - kələ-kötür, qabarıq
curse - lənət
apprehend - tutmaq, həbs etmək
swear - and içmək
rental - icarə haqqı
depart - yola çıxmaq
nevertheless - yenə də, lakin, buna baxmayaraq
occupation - sənət, peşə
overseas - xarici, denizaşırı
scholar - alim
stir - qarışdırmaq
sightseeing - gəzib-görmək, görməli yerlər
cruise - dəniz səyahəti
cliff - uçurum
delight - zövq, feeling happy
considerable - böyük, önəmli
fare - gediş haqqı
condemn - məhkum etmək
empowerment - güclənmə
precaution - önləm, ehtiyat tədbirləri
arrogant - kinli
guilty - günahkar
offended - incik, küskün
prompt - (hadisə və ya fakt) səbəb və ya əmələ gətirən (bir hərəkət və ya hiss).
plot - sujet, qəsd, sahə
flip flops - vetnamka
glitz - parıldamaq
high heeled shoes - uzun daban ayaqqabı
loose - gen-bol, sərbəst, yumuşaq
addiction - asılılıq
be fed up with - sıxılmaq
seagulls - qağayı
inicerate - yandırmaq
currency - valyuta
hold, warehouse - ambar
lamb - kuzu
cod - dalga geçmek ?
chewing - çeynəmək
pork - donuz
bunch - komanda, qrup
reputation - etibar, şöhrət
hesitation - tərəddüt
recognition - təqdir
deed - əməl
refrigerate - dondurmaq, soyutmaq
insert - qoymaq
grant - icazə vermək
miner - mədənçi
pour - tökmək
presence - olma, varlıq
sewage - çirkab, kanalizasiya
raw - xam
convict - məhkum etmək
mourning - yas tutmaq
vaguely - çox az
exploit - istismar etmək, faydalanmaq
assure - təmin etmək
auspicious - xeyirli
trail - iz
expell - qovmaq
landlord - kirayə verən
plot - komplo
moisture - nəm, rütubət
dense - sıx, qatı  ex: dense fog
germ - mikrob
scheme - plan
slaughter - qırğın, kəsim
strike - tətil
dispute - münaqişə
grant a rise - maaş qaldırmaq
on the contrary - əksinə
roam - gəzmək, çöllərə düşmək
rioter - üsyançı
faint - huşunu itirmək
presently - hal hazırda
straight away - dərhal,
deck - göyərtə
sledge - xizək
in hope of ... - ... ümidiylə
pale - solğun
precious - qiymətli
in the meantime - bu vaxtda
peasant - kəndli
confiscate - müsadirə etmək
coal - kömür
in advance - əvvəlcədən
despair - ümidsizlik
rush into - tələsmək
acquaint - tanış olmaq
decay - çürümək
hesitate - tərəddüd etmək
neglect - etinasız yanaşmaq, məhəl qoymamaq
appetite - iştah
conscience - vicdan
verdict - qərar
corruption - rüşvətçilik
execute - edam etmək
janitor - qapıçı
in a row - arxa-arxaya, dalbadal
casualty - yaralı, ölü
shrub - çalı
dimple - qəmzə
felony - cinayət, suç
brag - lovğalanmaq, özünü öymək
bare - yalın, çılpaq
hook - qarmaq, ilişdirmək
cast - atmaq, tullamaq
inn - mehmanxana, otel
pot - qazan
subtract - çıxarmaq
inference - nəticə, nəticə çıxarmaq
ponderous - ağır
intensity - yoğunluk
volatility - dəyişkənlik
condescending - alçaldıcı
bolster - dəstəkləmək, dayaq olmaq
hovel - kulübe
scorn - alçatmaq
attire - geyim
peasant - kəndli
drawback - minus, dezavantaj
saturated (unsaturated) fat - doymuş (doymamış) yağ
consume - istehlak etmək, istifadə etmək
intake - alım
blood clotting - qan laxtalanması
inflammation - iltihab
impure - natəmiz
contaminant - çirkləndirici
outnumber - sayca üstələmək, çox olmaq
outgrow - böyümək, keçmək
outlive - daha çox yaşamaq
outweigh - daha ağır olmaq
outwit - bicliklə birinə qalib gəlmək
convict - məhkum, məhbus  məhkum etmək
cope (with) - öhdəsindən gəlmək
pay off - borcu bağlamaq
hold back - özünü saxlamaq
hold up - gecikdirmək,
shop around - bir şeyi ən yaxşı qiymətə almaq üçün mağaza-mağaza gəzmək
emerge - ortaya çıxmaq
resident - sakin
plausible - məntiqə uyğun
strict - ciddi, sərt
wand - çubuq
detrimental - zərərli
pork - donuz əti
poultry - quş əti, ev quşları
palm - xurma
bologna - kolbasa
correlation - əlaqə
aqueduct - su kəməri
strait - çətin vəziyyət
endow - bəxş etmək
parlor - salon
filthy - kirli
vultures - leşyeyən
clergy - ruhani, din xadimləri
breezeway - koridor
courtesy  - nəzakət
privilege - imtiyaz
trainee - praktikant
preliminary - ilk
furlough - icazə, məzuniyyət
regimen - müalicə kursu
insistent - inadkar
insult - təhqir
fec - nəcis
deter - çəkinmək
invigorate - canlandırmaq, güc vermək
unsung - tanınmış, qədri bilinməyən
venture - cəsarət etmək, risk etmək
secure - təmin etmək
leer - yan baxmaq
musty - xarab, kifli, xarab
workforce - işçi qüvvəsi
swing - döndərmək
momentum - gedişat
imperative - vacib, əmr
unruly - itaətsiz
tame - əhliləşdirmək
tranquil - sakit
canny - ağıllıca (biznesdə)
budget–conscious - uyğun maliyyəli
subject - uğramaq
fellow - sevgili
seal - banka
negligence - səhlənkarlıq
shrink - qaçmaq
a household name - tanınmış ad, hamının tanıdığı adam
momentous - çox vacib
confidential - gizli
avert - qarşısını almaq, gözlərini qaçırtmaq, düşüncələrini dəyişdirmək
promptly - dərhal
hardened - sərt
gown - önlük
woozy - havalı
incisions - kəsik
visionary - xəyalpərəst
correctional - islah, cəzalandırma
penalize - cəzalandırmaq, to cause someone a disadvantage
commonplace - adi
straightforward - sadə
subdue - bir şeyin mövcud olmasının və ya inkişaf etməsinin qarşısını almaq
inmate - məhkum
cleanse - təmizləmək
lavish - təmtəraqlı, bol, dəbdəbəli
extravagant - israfçı
prosecutor - ittihamçı
overhear - təsadüfən eşitmək
stallion - at
look into - araşdırmaq
gouge - oymaq
socket - yuva
behold - baxmaq, görmək
refinement - zəriflik
shackled - qandallı, zəncirli
sack - torba   a sack lunch
extruded - işlənmiş   extruded meats
no offense - üstünə götürmə
longshoreman - liman işçisi
oyster - istridyə
ease - dindirmək (ağrı)
assumption - fərziyyə, təxmin
insinuate - uydurmaq, nəyisə altdan-altdan demək
exhibit - sərgiləmək
adeptly - ustaca, bacarıqla
debase - bayağılaşdırmaq, pozmaq
deterrent - something that deters people from doing something
heinous - çox pis, iyrənc
snap - ağlını itirmək
depravity - əxlaqsızlıq
mutilate - kəsərək xəsarət yetirmək
shatter - parçalamaq, qırmaq
decapitate - başını kəsmək
scattered - dağınıq, səpələnmiş
brighten up - canlandırmaq, şənləndirmək
put away - həbsə atmaq
relieve - azaltmaq
serene - sakit
sever - kəsmək
rotate - döndərmək, fırlatmaq
involuntary - qeyri-ixtiyarı
insensate - hissiz, duyğusuz
emerge - ortaya çıxmaq
proceed - davam etmək
evaluation - dəyərləndirmə
refreshment - sərinlidici içki
falsify - saxtalaşdırmaq, saxtakarlıq etmək
credential - kimlik
stewardship - idarəçilik
take over - təhvil almaq
dazzle - təsir etmək, heyran etmək
insipid - yavan
discretion - təmkinlilik, ehtiyat
paramount - hər şeydən çox vacib
olfactory - qoxu alma bacarığı
damp - nəm, rütubət
breach - pozuntu
brazen - həyasız
reprimanded - danlamaq, töhmət
proclivity - meyil
deviant - sapma
contraption - mexanizm
so to speak - deməli
malady - xəstəlik
explicit - açıq
balmy - rahatladıcı
plague - bezdirmək, usandırmaq
evidently - açıq-aşkar
masterstroke - ustaca hərəkət
humane - humanist, insani
strangle - boğmaq
fatigue - yorğunluq
short-sighted - irəlini görə bilməyən, gələcəyi fikirləşməyən
alert - xəbərdarlıq etmək
suffice - kifayət etmək, bəs etmək, yetmək
harsh - sərt
exultation - sevinc
matrimony - nikah, evlilik
predilection - meyil, aludəlik
bedevil - alt-üst etmək, məhv etmək
undermine - sarsıtmaq, lağım atmaq
vermin (plural) - zərərverici həşəratlar
insubordination - itaətsizlik, başqaldırma
yahoo - cahil, avam 
tolerate - dözmək, səbr eləmək
imbecile - gicbəsər
elusive - əlçatmaz
anticipated - gözlənilən
inaccurate - dəqiq olmayan, qeyri-dəqiq
intruder - çağırılmamış qonaq
shaken - məyus, sarsılmış
insatiable - doymaz, acgöz
beloved - sevilən
resignations - istefa
gratitude - minnətdarlıq, təşəkkür
persistent - inadcıl, inadkar
exterior - zahiri
demotion - vəzifədən salma
hamfisted - bacarıqsız yöntəm
ail - rahatsız etmək
notoriously - in a way that is famous for something bad
proper - düzgün, müvafiq
decisive - able to make decisions quickly and confidently, or showing this quality
rebuff - qəti şəkildə rədd etmək
advance - an attempt to start a romantic relationship with smby
plotting - hiylə qurmaq, komplo qurmaq
carry out - həyata keçirmək, gerçəkləşdirmək
enchantress - cadugər
toad - qurbağa
oak - palıd
cauldron - böyük qazan
potion - iksir
hare - dovşan
gaze - baxmaq, uzun baxış
underprivileged - imkansız
to an extent - müəyyən dərəcədə
prosperity - rifah
leak - sızma
disastrous - məhvedici,
debris - söküntü, töküntü, enkaz
beyond recognition - tanınmaz dərəcədə. 